"Date","HHSC","ALF_Fac_Outbreak_Active","ALF_Fac_Outbreak_Recovered","ALF_Fac_Outbreak_Cumulative","ALF_Cases_Active","ALF_Recovered_Cumulative","ALF_Deaths_Cumulative","ALF_Cases_Cumulative","ALF_Discharges_Cumulative","NURSING_Fac_Outbreak_Active","NURSING_Fac_Outbreak_Recovered","NURSING_Fac_Outbreak_Cumulative","NURSING_Cases_Active","NURSING_Recovered_Cumulative","NURSING_Deaths_Cumulative","NURSING_Cases_Cumulative","NURSING_Discharges_Cumulative"
2020-09-22,"1","20","17","37","29","47","9","93",NA,"50","23","73","161","627","158","1001",NA
2020-09-22,"2","6","38","44","4","143","20","188",NA,"47","68","115","193","1862","394","3006",NA
2020-09-22,"3","58","111","169","47","368","156","631",NA,"86","111","197","298","2487","587","3962",NA
2020-09-22,"4","23","28","51","23","110","37","177",NA,"89","78","167","434","2436","473","3752",NA
2020-09-22,"5","52","19","71","53","196","63","340",NA,"100","45","145","439","1755","405","2789",NA
2020-09-22,"6","31","136","167","45","608","140","929",NA,"66","104","170","212","3418","672","5578",NA
2020-09-22,"7","33","46","79","53","172","68","327",NA,"109","105","214","365","4453","1186","7649",NA
2020-09-23,"1","20","17","37","29","47","9","93",NA,"51","23","74","162","633","159","1009",NA
2020-09-23,"2","5","40","45","3","143","21","189",NA,"44","71","115","186","1954","397","3049",NA
2020-09-23,"3","55","113","168","43","370","156","633",NA,"85","113","198","284","2503","589","3970",NA
2020-09-23,"4","24","27","51","23","110","37","177",NA,"88","80","168","409","2438","489","3785",NA
2020-09-23,"5","51","20","71","52","198","63","335",NA,"99","46","145","436","1791","406","3044",NA
2020-09-23,"6","28","139","167","44","609","141","934",NA,"57","113","170","210","3431","673","5627",NA
2020-09-23,"7","27","53","80","47","186","69","335",NA,"103","112","215","380","4493","1196","7736",NA
2020-09-24,"1","20","17","37","29","47","9","93",NA,"51","23","74","168","634","159","1016",NA
2020-09-24,"2","5","40","45","3","143","21","189",NA,"47","68","115","193","1954","397","3056",NA
2020-09-24,"3","55","113","168","42","372","156","634",NA,"86","113","199","287","2507","594","3982",NA
2020-09-24,"4","25","26","51","23","110","37","177",NA,"90","79","169","410","2441","489","3794",NA
2020-09-24,"5","50","21","71","46","198","63","335",NA,"98","47","145","415","1818","407","3051",NA
2020-09-24,"6","28","140","168","42","609","139","931",NA,"50","120","170","205","3435","674","5633",NA
2020-09-24,"7","28","53","81","47","188","69","337",NA,"101","114","215","408","4553","1191","7847",NA
2020-09-25,"1","19","18","37","29","47","9","93","8","53","22","75","172","635","159","1021","55"
2020-09-25,"2","5","40","45","3","143","21","189","22","48","67","115","202","1958","398","3065","507"
2020-09-25,"3","55","113","168","42","372","156","634","64","83","116","199","291","2513","595","3993","594"
2020-09-25,"4","25","26","51","24","110","37","178","7","92","79","171","395","2458","498","3801","450"
2020-09-25,"5","50","21","71","46","198","63","335","28","98","47","145","418","1846","415","3093","414"
2020-09-25,"6","23","145","168","36","614","139","934","145","51","119","170","214","3435","674","5642","1319"
2020-09-25,"7","28","53","81","47","187","69","336","33","98","117","215","386","4531","1191","7837","1729"
2020-09-26,"1","20","18","38","25","47","13","93","8","54","21","75","180","635","160","1039","64"
2020-09-26,"2","4","41","45","3","143","21","189","22","46","70","116","203","1952","398","3055","502"
2020-09-26,"3","55","113","168","42","372","156","634","64","81","118","199","301","2553","600","4050","596"
2020-09-26,"4","25","26","51","24","110","37","178","7","92","79","171","378","2486","499","3816","453"
2020-09-26,"5","51","21","72","46","198","63","335","28","97","48","145","417","1849","415","3096","415"
2020-09-26,"6","21","147","168","34","616","139","934","145","49","121","170","217","3452","675","5682","1338"
2020-09-26,"7","28","53","81","47","187","69","336","33","101","114","215","403","4533","1196","7879","1747"
2020-09-27,"1","20","18","38","26","45","13","93","9","53","22","75","176","639","160","1039","64"
2020-09-27,"2","4","41","45","3","143","21","189","22","46","70","116","203","1952","398","3055","502"
2020-09-27,"3","55","113","168","41","374","156","635","64","81","118","199","297","2567","600","4061","597"
2020-09-27,"4","25","26","51","24","110","37","178","7","95","76","171","382","2499","499","3837","457"
2020-09-27,"5","51","21","72","46","198","63","335","28","97","48","145","417","1849","415","3096","415"
2020-09-27,"6","21","147","168","34","616","139","934","145","48","122","170","207","3467","676","5685","1335"
2020-09-27,"7","28","53","81","47","187","69","336","33","101","114","215","416","4542","1196","7905","1751"
2020-09-28,"1","20","18","38","27","45","13","94","9","53","22","75","195","639","160","1060","66"
2020-09-28,"2","4","41","45","3","143","21","189","22","46","70","116","203","1952","398","3053","502"
2020-09-28,"3","55","113","168","41","374","156","635","64","82","117","199","293","2576","601","4067","597"
2020-09-28,"4","24","27","51","24","111","37","181","9","92","80","172","366","2529","502","3854","460"
2020-09-28,"5","51","21","72","46","198","63","335","28","97","49","146","418","1859","416","3095","412"
2020-09-28,"6","19","149","168","34","616","139","934","145","48","122","170","210","3478","676","5680","1346"
2020-09-28,"7","29","53","82","46","188","69","336","33","100","117","217","395","4546","1197","7873","1758"
2020-09-29,"1","22","18","40","29","45","13","96","9","54","23","77","199","641","161","1078","77"
2020-09-29,"2","4","41","45","3","143","21","189","22","47","69","116","234","1956","398","3036","486"
2020-09-29,"3","55","113","168","41","374","156","635","64","82","117","199","293","2576","601","4067","597"
2020-09-29,"4","24","27","51","25","111","37","180","7","91","82","173","355","2566","502","3880","460"
2020-09-29,"5","51","21","72","46","198","63","335","28","97","49","146","413","1870","421","3106","412"
2020-09-29,"6","20","148","168","36","616","139","936","145","48","122","170","230","3483","677","5668","1327"
2020-09-29,"7","29","53","82","46","188","69","336","33","97","120","217","387","4556","1198","7851","1762"
2020-09-30,"1","21","19","40","27","45","15","97","10","55","23","78","192","674","168","1112","78"
2020-09-30,"2","5","40","45","3","143","21","189","22","53","63","116","233","1952","397","3025","480"
2020-09-30,"3","56","114","170","44","379","158","652","72","82","117","199","352","2618","604","4184","612"
2020-09-30,"4","25","27","52","30","111","38","186","7","92","81","173","348","2619","510","3923","457"
2020-09-30,"5","51","21","72","46","198","63","335","28","94","52","146","393","1905","431","3132","412"
2020-09-30,"6","19","149","168","35","618","139","936","146","48","122","170","225","3484","677","5672","1335"
2020-09-30,"7","24","58","82","47","191","70","341","33","96","121","217","413","4582","1201","7874","1765"
2020-10-01,"1","21","19","40","27","45","15","97","10","55","23","78","192","674","169","1113","78"
2020-10-01,"2","6","39","45","3","143","21","189","22","52","64","116","228","1952","398","3030","490"
2020-10-01,"3","60","112","172","47","379","158","655","72","78","122","200","345","2636","613","4211","619"
2020-10-01,"4","27","26","53","32","111","38","188","7","94","80","174","309","2658","513","3948","481"
2020-10-01,"5","51","21","72","46","198","63","335","28","96","50","146","392","1909","432","3137","413"
2020-10-01,"6","19","149","168","35","619","139","937","146","45","125","170","200","3509","677","5683","1360"
2020-10-01,"7","19","63","82","45","193","70","341","33","95","122","217","401","4624","1205","7916","1799"
2020-10-02,"1","22","19","41","28","46","15","99","10","56","22","78","243","688","172","1183","80"
2020-10-02,"2","6","39","45","3","143","21","189","22","53","63","116","231","1959","399","3047","497"
2020-10-02,"3","60","113","173","45","380","158","656","74","77","123","200","348","2659","615","4248","628"
2020-10-02,"4","28","26","54","34","112","38","191","7","93","82","175","299","2705","522","4000","487"
2020-10-02,"5","51","22","73","46","198","69","341","28","97","49","146","439","1923","440","3207","414"
2020-10-02,"6","19","149","168","33","620","139","936","146","43","127","170","191","3515","677","5683","1363"
2020-10-02,"7","20","63","83","45","193","70","341","33","95","122","217","387","4646","1212","7966","1840"
2020-10-03,"1","22","19","41","28","46","15","99","10","56","22","78","243","690","171","1184","80"
2020-10-03,"2","8","39","47","1","145","21","189","22","56","60","116","235","1956","400","3065","513"
2020-10-03,"3","61","114","175","44","384","158","660","75","76","124","200","348","2712","623","4605","939"
2020-10-03,"4","28","26","54","34","112","38","191","7","97","79","176","312","2711","528","4028","492"
2020-10-03,"5","51","22","73","46","198","69","341","28","98","48","146","421","1959","449","3263","444"
2020-10-03,"6","19","149","168","32","621","139","936","146","44","126","170","138","3571","680","5705","1368"
2020-10-03,"7","20","63","83","43","193","70","341","35","95","122","217","348","4664","1215","7981","1845"
2020-10-04,"1","21","20","41","24","48","15","97","10","56","22","78","255","691","173","1199","80"
2020-10-04,"2","9","39","48","2","145","21","190","22","56","60","116","236","1956","400","3068","516"
2020-10-04,"3","60","115","175","43","384","158","660","76","76","125","201","346","2728","623","4640","960"
2020-10-04,"4","30","26","56","36","112","38","196","10","98","78","176","320","2715","528","4040","492"
2020-10-04,"5","51","22","73","46","198","69","341","28","98","48","146","421","1959","449","3263","444"
2020-10-04,"6","20","148","168","32","620","139","936","147","43","127","170","133","3576","680","5705","1368"
2020-10-04,"7","20","63","83","47","193","70","347","37","93","124","217","347","4669","1215","7996","1860"
2020-10-05,"1","21","20","41","24","48","15","97","10","56","22","78","261","691","173","1206","81"
2020-10-05,"2","8","40","48","1","145","21","190","23","56","61","117","241","1969","401","3083","514"
2020-10-05,"3","60","115","175","44","384","158","661","76","76","125","201","347","2731","622","4646","963"
2020-10-05,"4","27","29","56","38","112","38","198","10","99","77","176","308","2745","532","4037","469"
2020-10-05,"5","51","22","73","46","198","69","341","28","99","47","146","441","1878","457","3220","454"
2020-10-05,"6","19","149","168","32","622","139","936","145","43","127","170","132","3577","680","5705","1368"
2020-10-05,"7","20","64","84","47","193","71","349","38","94","123","217","334","4669","1216","7983","1860"
2020-10-06,"1","21","20","41","24","48","15","97","10","54","24","78","255","713","175","1224","81"
2020-10-06,"2","8","40","48","1","145","21","190","23","55","62","117","227","2006","404","3107","511"
2020-10-06,"3","63","114","177","45","384","158","662","76","82","119","201","379","2754","624","4698","992"
2020-10-06,"4","25","32","57","36","115","38","199","10","98","78","176","309","2787","536","4086","481"
2020-10-06,"5","51","22","73","46","198","69","341","28","97","50","147","456","1884","459","3244","455"
2020-10-06,"6","19","149","168","34","624","140","943","145","43","127","170","131","3582","680","5711","1368"
2020-10-06,"7","16","68","84","47","193","71","349","38","92","125","217","316","4702","1219","7971","1830"
2020-10-07,"1","18","23","41","16","56","15","97","10","54","24","78","247","737","177","1246","85"
2020-10-07,"2","8","40","48","1","145","21","190","23","55","62","117","145","2087","405","3101","505"
2020-10-07,"3","64","115","179","69","386","159","691","78","82","119","201","406","2797","630","4827","1042"
2020-10-07,"4","26","32","58","43","115","40","207","10","87","90","177","304","2863","541","4188","509"
2020-10-07,"5","48","23","71","44","198","69","335","24","73","69","142","382","1936","473","3268","485"
2020-10-07,"6","16","152","168","30","627","140","942","145","37","133","170","113","3597","681","5717","1369"
2020-10-07,"7","16","68","84","48","193","71","351","39","88","129","217","297","4721","1223","8022","1861"
2020-10-08,"1","19","23","42","19","56","15","101","11","54","24","78","255","737","176","1253","85"
2020-10-08,"2","10","40","50","0","146","21","190","23","54","64","118","144","2092","405","3112","512"
2020-10-08,"3","64","116","180","68","388","159","692","77","84","118","202","418","2850","631","5033","1182"
2020-10-08,"4","27","32","59","60","116","40","225","10","89","88","177","265","2882","547","4190","526"
2020-10-08,"5","50","26","76","45","204","71","344","25","69","74","143","346","1996","476","3249","440"
2020-10-08,"6","11","157","168","21","634","140","941","146","31","139","170","98","3619","681","5733","1369"
2020-10-08,"7","15","69","84","40","208","71","361","42","84","133","217","249","4759","1224","8110","1953"
2020-10-09,"1","19","23","42","26","56","15","108","11","54","24","78","271","755","185","1302","91"
2020-10-09,"2","9","41","50","0","146","21","190","23","58","60","118","186","2102","405","3168","515"
2020-10-09,"3","64","117","181","73","389","162","702","78","84","119","203","465","2874","633","5099","1192"
2020-10-09,"4","27","32","59","52","121","41","222","9","92","85","177","275","2885","550","4232","560"
2020-10-09,"5","50","26","76","45","204","71","344","25","69","74","143","359","2024","482","3309","453"
2020-10-09,"6","11","157","168","18","634","141","939","146","34","136","170","85","3625","683","5729","1370"
2020-10-09,"7","15","69","84","40","208","71","362","43","86","131","217","241","4766","1226","8116","1957"
2020-10-10,"1","18","24","42","25","58","15","109","11","53","25","78","263","765","189","1317","100"
2020-10-10,"2","9","42","51","0","146","21","190","23","59","59","118","217","2103","405","3201","516"
2020-10-10,"3","67","116","183","81","399","162","718","76","86","119","205","465","2884","634","5021","1130"
2020-10-10,"4","27","32","59","52","121","41","222","9","93","84","177","266","2907","552","4242","556"
2020-10-10,"5","50","27","77","45","205","71","345","25","67","77","144","356","2041","481","3325","457"
2020-10-10,"6","11","158","169","18","641","141","946","146","33","137","170","89","3629","684","5732","1370"
2020-10-10,"7","14","70","84","41","208","71","363","43","86","131","217","227","4765","1232","8133","1979"
2020-10-11,"1","18","24","42","25","58","15","109","11","52","26","78","263","766","189","1318","100"
2020-10-11,"2","9","42","51","0","146","21","190","23","60","58","118","220","2103","406","3207","518"
2020-10-11,"3","69","114","183","87","399","163","726","77","88","118","206","477","2900","634","5053","1135"
2020-10-11,"4","27","32","59","52","121","41","222","9","94","84","178","256","2911","556","4223","539"
2020-10-11,"5","50","27","77","45","205","71","345","25","67","78","145","360","2043","481","3333","459"
2020-10-11,"6","11","158","169","19","645","141","951","146","35","135","170","83","3640","684","5748","1373"
2020-10-11,"7","13","71","84","41","208","71","362","42","83","134","217","198","4780","1233","8144","2003"
2020-10-12,"1","18","24","42","26","58","15","110","11","55","23","78","265","774","189","1330","102"
2020-10-12,"2","10","41","51","0","146","21","190","23","59","59","118","234","2105","406","3223","518"
2020-10-12,"3","68","115","183","87","399","163","729","80","88","119","207","470","2923","634","5085","1162"
2020-10-12,"4","22","39","61","50","134","44","236","9","93","85","178","278","2928","559","4269","543"
2020-10-12,"5","47","29","76","38","208","71","348","32","67","79","146","339","2072","481","3345","463"
2020-10-12,"6","11","158","169","20","645","141","952","146","35","135","170","83","3643","684","5754","1373"
2020-10-12,"7","13","71","84","41","208","71","362","42","82","135","217","200","4823","1235","8184","1998"
2020-10-13,"1","18","24","42","28","58","15","112","11","55","23","78","293","791","191","1380","105"
2020-10-13,"2","12","39","51","1","146","21","192","24","55","63","118","253","2120","408","3259","518"
2020-10-13,"3","67","119","186","89","398","161","729","81","83","124","207","477","2919","637","5109","1184"
2020-10-13,"4","19","42","61","52","135","44","240","10","84","94","178","271","2942","562","4286","545"
2020-10-13,"5","49","29","78","42","208","71","352","32","66","81","147","278","2146","483","3398","499"
2020-10-13,"6","11","158","169","23","645","141","955","146","34","136","170","83","3652","684","5763","1373"
2020-10-13,"7","14","72","86","40","213","73","370","44","80","137","217","186","4839","1239","8200","2005"
2020-10-14,"1","18","24","42","25","62","16","119","16","54","24","78","325","812","192","1444","115"
2020-10-14,"2","11","40","51","35","147","21","227","24","65","54","119","298","2136","410","3318","520"
2020-10-14,"3","61","125","186","82","406","162","731","81","82","125","207","468","3045","657","5272","1202"
2020-10-14,"4","19","42","61","50","135","44","238","10","84","94","178","272","2971","563","4323","544"
2020-10-14,"5","49","29","78","42","208","71","352","32","67","81","148","278","2145","483","3391","493"
2020-10-14,"6","12","158","170","23","645","142","956","146","32","138","170","86","3661","684","5781","1373"
2020-10-14,"7","15","72","87","44","217","74","378","43","76","141","217","177","4855","1241","8212","2012"
2020-10-15,"1","19","24","43","25","62","16","119","16","54","24","78","329","822","196","1463","116"
2020-10-15,"2","12","39","51","39","147","21","231","24","65","54","119","302","2137","412","3333","527"
2020-10-15,"3","57","129","186","81","415","163","738","79","86","123","209","511","3070","660","5351","1217"
2020-10-15,"4","13","49","62","37","143","44","233","10","87","91","178","280","3013","570","4396","557"
2020-10-15,"5","48","30","78","42","208","71","352","32","66","82","148","283","2152","488","3407","492"
2020-10-15,"6","12","158","170","21","645","144","956","146","36","134","170","90","3662","684","5783","1373"
2020-10-15,"7","15","72","87","45","217","74","379","43","77","140","217","182","4866","1241","8231","2014"
2020-10-16,"1","20","24","44","29","62","16","123","16","54","24","78","328","828","203","1476","117"
2020-10-16,"2","11","40","51","37","146","23","230","24","65","55","120","310","2163","414","3383","541"
2020-10-16,"3","47","140","187","72","440","165","770","93","86","123","209","521","3093","669","5444","1273"
2020-10-16,"4","14","48","62","47","144","44","245","10","83","95","178","275","3086","578","4483","568"
2020-10-16,"5","40","37","77","57","211","82","383","34","61","87","148","257","2214","497","3452","491"
2020-10-16,"6","11","159","170","22","645","144","957","146","39","131","170","85","3669","685","5788","1375"
2020-10-16,"7","18","69","87","45","220","68","375","42","75","142","217","155","4897","1241","8227","1991"
2020-10-17,"1","20","24","44","28","64","16","123","15","55","24","79","307","847","205","1476","117"
2020-10-17,"2","11","40","51","37","146","23","230","24","64","56","120","312","2178","415","3408","548"
2020-10-17,"3","44","143","187","68","446","165","780","101","84","126","210","511","3117","670","5485","1284"
2020-10-17,"4","16","47","63","48","148","45","251","10","80","98","178","270","3112","579","4480","543"
2020-10-17,"5","38","40","78","54","211","82","386","39","60","88","148","265","2234","505","3488","491"
2020-10-17,"6","11","159","170","21","645","144","956","146","40","130","170","90","3674","686","5800","1375"
2020-10-17,"7","12","75","87","65","205","68","336","42","69","148","217","161","4887","1243","8251","2029"
2020-10-18,"1","20","24","44","28","64","16","125","17","56","23","79","357","854","207","1544","126"
2020-10-18,"2","11","40","51","37","146","23","230","24","67","54","121","340","2192","417","3449","548"
2020-10-18,"3","44","143","187","68","449","166","783","100","86","124","210","507","3126","670","5497","1290"
2020-10-18,"4","15","48","63","48","148","45","251","10","79","101","180","278","3133","580","4516","547"
2020-10-18,"5","38","40","78","55","212","83","389","39","60","88","148","248","2250","505","3488","492"
2020-10-18,"6","12","158","170","24","645","144","959","146","41","129","170","90","3675","686","5803","1377"
2020-10-18,"7","12","75","87","64","208","75","345","42","68","149","217","172","4897","1246","8279","2033"
2020-10-19,"1","22","24","46","28","64","16","125","17","55","24","79","357","854","209","1545","125"
2020-10-19,"2","12","39","51","38","147","23","232","24","71","51","122","355","2195","418","3461","557"
2020-10-19,"3","42","145","187","68","449","166","783","100","86","124","210","550","3173","680","5631","1363"
2020-10-19,"4","12","51","63","50","153","46","259","10","80","100","180","282","3148","580","4538","549"
2020-10-19,"5","38","41","79","57","212","83","391","39","59","89","148","250","2251","505","3491","492"
2020-10-19,"6","11","159","170","22","645","144","957","146","41","129","170","90","3677","686","5814","1386"
2020-10-19,"7","11","76","87","16","233","75","366","42","68","149","217","177","4898","1246","8287","2035"
